13 20
00000000000000000000
11100111111111011110
11110011111111011110
11111001111111011110
11111100111111011110
11111110011111011110
00000000000000000000
00000000000000000000
01111111111111011111
01110011111111011111
01110011111111011111
01110011111111011111
00000000000000000000
