15 40
0000000000000000000000000000000000000000
0101111111111111111111111110111111111110
0101111116111111111411111110111151111110
0101111111111111111311111110111111112110
0100000000000000000000000000000000000000
0101111111101111111111111111111111111110
0101151111101121111116111111111115111110
0101111112101111141111111511111411111110
0101111111101111131121111111111311111110
0101115111100000000000000000000000000000
0101111121101161111111111102011511111110
0101111111101111111111161102011111121610
0101161111101111151111111102011151111110
0101111111101111111111111102011111111110
0000000000000000000000000000000000000000

