21 50
0 0 0 0 0 0 0 0 0 0 0 0 0 0 0 0 0 0 0 0 0 0 0 0 0 0 0 0 0 0 0 0 0 0 0 0 0 0 0 0 0 0 0 0 0 0 0 0 0 0
0 167 215 216 217 218 219 0 321 322 323 324 325 0 285 286 287 289 290 291 0 0 396 397 398 0 0 0 0 0 0 417 418 419 420 421 422 0 0 466 467 468 469 0 0 396 397 398 0 0
0 220 221 222 223 224 225 0 326 327 328 329 330 0 292 293 294 295 296 297 0 0 399 400 401 0 490 491 492 493 0 423 424 425 426 427 428 0 0 470 471 472 473 0 0 399 400 401 0 0
0 226 227 228 229 230 231 0 331 332 333 334 335 0 298 299 300 301 302 303 0 0 402 403 404 0 494 495 496 497 0 429 430 431 432 433 434 0 0 474 475 476 477 0 0 401 402 403 0 0
0 232 233 234 235 236 237 0 336 337 338 339 340 0 304 305 306 307 308 309 0 0 0 0 0 0 498 499 500 501 0 435 436 437 438 439 440 0 0 478 479 480 481 0 0 0 0 0 0 0
0 238 239 240 241 242 243 0 341 342 343 344 345 0 310 311 312 313 314 315 0 405 406 407 408 0 502 503 504 505 0 441 442 443 444 445 446 0 0 482 483 484 485 0 0 0 0 0 0 0
0 244 245 246 247 248 249 0 0 0 0 0 0 0 316 317 318 319 320 0 409 410 411 412 0 506 507 508 509 0 447 448 449 450 451 452 0 0 486 487 488 489 0 405 406 407 408 0 0
0 250 251 252 253 254 255 0 465 256 257 258 259 0 0 0 0 0 0 0 0 413 414 415 416 0 510 511 512 513 0 453 454 455 456 457 458 0 0 0 0 0 0 0 409 410 411 412 0 0
0 0 0 0 0 0 0 0 260 261 262 263 264 0 0 0 0 0 0 0 0 0 0 0 0 0 0 0 0 0 0 459 460 461 462 463 464 0 0 0 0 0 0 413 414 415 416 0 0
0 3 4 5 6 7 8 0 265 266 267 268 269 0 0 364 365 366 367 368 369 370 371 0 0 0 0 0 0 0 0 0 0 0 0 0 0 0 0 490 491 492 493 0 0 0 0 0 0 0
0 9 10 11 12 13 14 0 270 271 272 273 274 0 0 372 373 374 375 376 377 378 379 0 0 396 397 398 0 119 120 121 122 123 124 125 126 0 0 494 495 496 497 0 0 89 90 91 92 93
0 15 16 17 18 19 20 0 275 276 277 278 279 0 0 380 381 382 383 384 385 386 387 0 0 399 400 401 0 127 128 129 130 131 132 133 134 0 0 498 499 500 501 0 0 94 95 96 97 98
0 21 22 23 24 25 26 0 280 281 282 283 284 0 0 388 389 390 391 392 393 394 395 0 0 402 403 404 0 135 136 137 138 139 140 141 142 0 0 502 503 504 505 0 0 99 100 101 102 103
0 27 28 29 30 31 32 0 0 0 0 0 0 0 0 0 0 0 0 0 0 0 0 0 0 0 0 0 0 143 144 145 146 147 148 149 150 0 0 506 507 508 509 0 0 104 105 106 107 108
0 33 34 35 36 37 168 0 38 39 40 41 42 43 44 45 46 47 0 0 175 176 177 178 179 180 181 182 0 151 152 153 154 155 156 157 158 0 0 510 511 512 513 0 0 109 110 111 112 113
0 169 170 171 172 173 174 0 48 49 50 51 52 53 54 55 56 57 0 0 183 184 185 186 187 188 189 190 0 159 160 161 162 163 164 165 166 0 0 0 0 0 0 0 0 0 0 0 0 0
0 0 0 0 0 0 0 0 58 59 60 61 62 63 64 65 66 67 0 0 191 192 193 194 195 196 197 198 0 0 0 0 0 0 0 0 0 0 0 0 396 397 398 0 0 0 0 0 0 0
0 346 347 348 349 350 351 0 68 69 70 71 72 73 74 75 76 77 0 0 199 200 201 202 203 204 205 206 0 0 0 0 346 347 348 349 350 351 0 0 399 400 401 0 0 405 406 407 408 0
0 352 353 354 355 356 357 0 78 79 80 81 82 83 84 85 86 87 0 0 207 208 209 210 211 212 213 214 0 0 0 0 352 353 354 355 356 357 0 0 402 403 404 0 0 409 410 411 412 0
0 358 359 360 361 362 363 0 0 0 0 0 0 0 0 0 0 0 0 0 0 0 0 0 0 0 0 0 0 0 0 0 358 359 360 361 362 363 0 0 0 0 0 0 0 413 414 415 146 0
0 0 0 0 0 0 0 0 0 0 0 0 0 0 0 0 0 0 0 0 0 0 0 0 0 0 0 0 0 0 0 0 0 0 0 0 0 0 0 0 0 0 0 0 0 0 0 0 0 0 0 0

